0000000010
0000000100
0000001000
0020010000
0020000000
0020200110
0020200000
0020201100
0020200011
0020200000