0000000010
0000000100
0000001000
0030010000
0020000000
0020300110
0020200000
0020201100
0020200011
0020200000